222222222222222222222
211000000000000000112
212020212020212020212
200011100001110000002
202021202020202020202
200011100000010000002
202020202020212020202
200111000101000000002
212020202021202021212
211000000000000000112
222222222222222222222
