222222222222222222222
220000000000000000022
202000011100111000202
200200011100111002002
200020011100111020002
200002000000000200002
200000200000002000002
201110020000020011102
201110002000200011102
201110000202000011102
200000000000000000002
201110000202000011102
201110002000200011102
201110020000020011102
200000200000002000002
200002000000000200002
200020111001110020002
200200111001110002002
202000111001110000202
220000000000000000022
222222222222222222222