222222222222222222222
200000000000000000002
200000000000000000002
200000000000000000002
222222222101222222222
222222222010222222222
222222222101222222222
222222222010222222222
222222222101222222222
222222222010222222222
222222222101222222222
200000000000000000002
200000000000000000002
200000000000000000002
222222222222222222222