22222222222222222222
20000000000000000002
20202020202020202022
21111111111111111111
21111111111111111111
20000000000000000002
21221211212121212121
22222221022222222222
21111111110000000002
21111111112222222222
21111111112222222222
22222222222222222222