2222222222222222222
2000001111111000002
2000001111111000002
2001111111111111102
2001111111111111102
2111111111111111112
2111111111111111112
2111100011100011112
2111100011100011112
2111111111111111112
2111111111111111112
2111111111111111112
2000001110011100002
2000001110011100002
2000111011101110002
2000111011101110002
2111000000000001112
2111000000000001112
2222222222222222222