222222222222222222222222222222222222
200011110111000000000001111111000002
200002122111000010000111110022222112
200010101111000000001011110000022222
211100001001111100000111110000211022
211222200000000000001111111000000112
211220000000000000000222220000011112
200000000000000000000000000000000002
200000000000000000000000000000000002
200000000000000000000000000000000002
200000000000000000000000000000000002
200000000000000111111111000000000002
200000000000000111111111000000000002
201111111100000000000000111111111112
201000000011111111110000000011111112
222222222222222222222222222222222222